NO src/textures/a.xpm
SO src/textures/a.xpm
WE src/textures/a.xpm
EA src/textures/a.xpm
F 220,100,0
C 225,30,0

11111111111111111111111111111
10000000000000000000000000001
10000000000000000000000000001
10000000000000000000000000001
10000000000000000000000000001
10000000000000000000000000001
10000000011111110000000000001
1000000001111111110000000011
1000000001111111110000000001
10000000011111110000000000001
10000000000000000000000000001
10000000000000000000000000001
10000000000000000000000000001
10000000000000000000000000001
10000000000000000000000000001
11111111111111111111111111111
