

      NO       srcs/imgs/wall_text/a.xpm
SO	srcs/imgs/wall_text/b.xpm



EA srcs/imgs/wall_text/c.xpm



F 30,240,200

	    	WE   			 srcs/imgs/wall_text/d.xpm
C 40,12,240


11111111
10000N1
10101111
1000001
11111111