NO       src/textures/a.xpm
SO		src/textures/a.xpm
EA src/textures/a.xpm
WE   			 src/textures/a.xpm

F 127, 127, 127
C 135, 206, 250

1111111111111111111111111111
1aaaaaaa10010011000000000001
1111111111111111111111111111
