NO       src/textures/a.xpm
SO		src/textures/a.xpm
EA src/textures/a.xpm
WE   			 src/textures/a.xpm

F 127, 127, 0
C 135,      ,


1111111111111111111111111111
1E00000100100110000000000001
1111111111111111111111111111
