NO       src/textures/a.xpm
SO		src/textures/a.xpm
EA src/textures/a.xpm
WE   			 src/textures/a.xpm

F 127, 127, 127
C 135, 206, 250

1111111111111111111111111111
1000000100100110000000000001
11E1111111111111111111111111
