NO ./textures/NO.xpm
SO ./textures/SO.xpm
WE ./textures/WE.xpm
EA ./textures/EA.xpm

F 127, 127, 127
C 135, 206, 250

1111111111111111111111111111
1000000100100110000000000001
111111111111111111111111111N
