



NO src/textures/a.xpm
SO src/textures/b.xpm
EA src/textures/c.xpm
E src/textures/d.xpm

F 24,67,10
C 252,12,255

11111111
1N   1  
1 1 111 
1    1  
11111111