



NO ./path_to_the_north_texture
SO ./path_to_the_south_texture
E ./path_to_the_west_texture
EA ./path_to_the_east_texture

F 30,30,12
C 252,32,30

1111111
1N   1
1 1 111
1    1
1111111