



NO src/textures/painting.xpm
SO src/textures/bookshelf.xpm
EA src/textures/bookshelf.xpm
WE src/textures/gemov4.xpm

F 33,33,33
C 178,218,250
111111111111
10         1
1 1 111    1
1    1     1
1111111N1110
       1