



NO src/textures/a.xpm
SO src/textures/a.xpm
EA src/textures/a.xpm
E src/textures/a.xpm

F 30,30,12
C 252,32,30

11111111
1N   1  
1 1 111 
1    1  
11111111