



NO src/textures/a.xpm
SO src/textures/a.xpm
EA src/textures/a.xpm
E src/textures/a.xpm

F 0,130,12
C 0,32,30

11111
1N  1
1 1 1
1   1
11111