



NO src/textures/a.xpm
SO src/textures/a.xpm
EA src/textures/a.xpm
WE src/textures/a.xpm

F  125,126,30
C  173,216,230

11111
1N  1
1 1 1
1   1
11111