



NO src/textures/a.xpm
SO src/textures/a.xpm
EA src/textures/a.xpm
E src/textures/a.xpm

F 220,100,0
C 225,30,0


            111111111111111111111
            100000000011000000001
            101100000111000000001
            100100000000000000001
111111111111100001110000000011111
100000000011000001110111011111111
11110111111111011100000010001    
11110111111111011101010010001    
11000000110101011100000010001    
10000000000000001100000010N01    
10000000000000001101010010001   
1100000111010101111101111000111  
11110111 1110101 101111010001    
11111111 1111111 111111111111    