



NO src/textures/a.xpm
SO src/textures/a.xpm
EA src/textures/a.xpm
WE src/textures/a.xpm

F 220,100,0
C 225,30,0


 1111111
 1S10101
1000101
100001
1111111
