



NO src/textures/a.xpm
SO src/textures/a.xpm
EA src/textures/a.xpm
E src/textures/a.xpm

F 220,100,0
C 225,30,0


 1111111
 10E0001
1100001
1111111