



NO src/textures/gemov1.xpm
SO src/textures/gemov1.xpm
EA src/textures/gemov1.xpm
WE src/textures/gemov1.xpm

F 33,33,33
C 178,218,250


 1111111
 1S10101
1000101
100001
1111111
